R 640 480

111111
100101
102001
1100N1
111111